NO ./assets/isaac.xpm
SO ./assets/wall.xpm
WE ./assets/backrooms.xpm
EA ./assets/wall.xpm

F ./assets/isaac.xpm
C 255,0,0

11111111111111111111111111111111111111111
10000000000001111111111111111111111111111
10000000000001000000000000000000000000011
10000101010001010101010101010101010101011
10N00000000001000000000000000000000000011
10000101010001010101010101010101010101011
10000000000001000000000000000000000000011
10000101010001010101010101010101010101011
10000000000001000000000000000000000000011
10000101010001010101010101010101010101011
11111111111111111111111111111111111111111
