0 {
	NO ./assets/isaac.xpm
	SO ./assets/wall.xpm
	WE ./assets/backrooms.xpm
	EA ./assets/isaac.xpm

	F ./assets/wall.xpm
	C ./assets/isaac.xpm
	W 0
}

A {
	NO ./assets/isaac.xpm
	SO ./assets/wall.xpm
	WE ./assets/backrooms.xpm
	EA ./assets/wall.xpm

	F ./assets/backrooms.xpm
	C ./assets/wall.xpm
	W 0
}
1 {
	NO ./assets/isaac.xpm
	SO ./assets/wall.xpm
	WE ./assets/backrooms.xpm
	EA ./assets/isaac.xpm

	F ./assets/backrooms.xpm
	C ./assets/wall.xpm
	W 1
}

2 {
	NO ./assets/isaac.xpm
	SO ./assets/wall.xpm
	WE ./assets/wall.xpm
	EA ./assets/isaac.xpm

	F ./assets/backrooms.xpm
	C ./assets/wall.xpm
	W 1
}

8 {
	NO ./assets/backrooms.xpm
	SO ./assets/backrooms.xpm
	WE ./assets/backrooms.xpm
	EA ./assets/wall.xpm

	F ./assets/isaac.xpm
	C ./assets/wall.xpm
	W 1
}

18188811111111111111111111111111111111111
10000000000001111111111111111111111111111
10000000000001000000000000000000000000011
10000101010001010101010101010101010101011
10000200000001000000000000000000000000011
80N00101010001010101010101010101010101011
10000000000001000000000000000000000000011
10000101010001010101010101010101010101011
10000000A00001000000000000000000000000011
10000101010001010101010101010101010101011
10000000000001000000000000000000000000011
10111110011111111111110111111111111111111
101000100000A0000000000000000000011111111
10101011111111000000000000000000011111111
10101111000001000000000000000000011111111
10100001000001000000001111111000000000001
10111101000001000000001111111000000000001
10000001000000000000001111111010111111001
11111111001111000000001111111000000000001
10000001000000000000000000001001001001001
10000001000000000000000000001000110001001
10011111000000000100000000001000110001001
10000000000000000100000000001001001001001
11110011100000000100000000001000000000001
10000000100000000111111000001111111111111
10000000100000000100000000000000000000001
10000000100000000101111000000000000000001
10000000000000000100001000000000000000001
10000000000000000111111100000000001111101
10000000000000000100000000000000000000001
10101010101010100100000000011110000000001
10000000000000000100000000000010000000001
10101010101010100100000000000000000000001
10000000000000000100011111111111111111101
10101010101010100000000000000100000000001
10000000000000000000000000000101111111111
10101010101010100001111111100000000000001
10000000000000000001000000000111111111111
10101010101010100001000000100100000000001
10000000000000000000000000100101101101101
10101010101010100000010000000100000000001
10000000000000000000010000000101101101101
11111111111111101111111111111100000000001
11111111111111111111111111111111111111111
