NO ./assets/isaac.xpm
SO ./assets/wall.xpm
WE ./assets/backrooms.xpm
EA ./assets/wall.xpm

F ./assets/isaac.xpm
C 255,0,0

11111111111111
1000000000000111111111111111111111111111
1000000000000100000000000000000000000001
1000010101000101010101010101010101010101
10N0000000000100000000000000000000000001
1000010101000101010101010101010101010101
1000000000000100000000000000000000000001
1000010101000101010101010101010101010101
1000000000000100000000000000000000000001
1000010101000101010101010101010101010101
1000000000000100000000000000000000000001
1011111001111111111111011111111111111111
1010001000000000000000000000000001
1010101111111100000000000000000001
10101111000001000000000000000000011111111
10100001000001000000001111111000000000001
10111101000001000000001     1000000000001
10000001000000000000001     1010111111001
11111111001111000000001111111000000000001
10000001000000000000000000001001001001001
10000001000000000000000000001000110001001
10011111000000000100000000001000110001001
10000000000000000100000000001001001001001
11110011100000000100000000001000000000001
10000000100000000111111000001111111111111
10000000100000000100000000000000000000001
10000000100000000101111000000000000000001
10000000000000000100001000000000000000001
10000000000000000111111100000000001111101
10000000000000000100000000000000000000001
10101010101010100100000000011110000000001
10000000000000000100000000000010000000001
10101010101010100100000000000000000000001
10000000000000000100011111111111111111101
10101010101010100000000000000100000000001
10000000000000000000000000000101111111111
10101010101010100001111111100000000000001
10000000000000000001000000000111111111111
10101010101010100001000000100100000000001
10000000000000000000000000100101101101101
10101010101010100000010000000100000000001
10000000000000000000010000000101101101101
11111111111111101111111111111100000000001
              111            111111111111
